wwwwwwwwwwwwwwwwwwwww
wp          w       w
w           w       w
w       ww  w      dw
w        w  w       w
w        wwww       w
w                   w
w                   w
w                   w
wwwwwwww            w
w      w    wwww    w
w      w    w       w
w      w            w
w      w            w
w                   w
w                   w
w         ww        w
w         ww        w
w         ww        w
w         ww       fw
wwwwwwwwwwwwwwwwwwwww