wwwwwwwwwwwwwwwwwwwww
w           w       w
w           w       w
w       ww  w      dw
w        w  w       w
w        wwww       w
w                   w
w       wwww        w
wp                  w
w wwwwww            w
w  w   w    wwww    w
w  w   w    w       w
w  w   w            w
w  wwwww            w
w     ww            w
w     ww            w
w     ww  wwwwwwwwwww
w     ww  ww        w
w     ww  ww        w
w                  fw
wwwwwwwwwwwwwwwwwwwww